R  500  500
NO ./pics/redbricks.xpm
SO ./pics/mossy.xpm
WE ./pics/wood.xpm
EA ./pics/greystone.xpm
S ./pics/barrel.xpm
F 320,100,03 
C 125,30,0
        1111111111111111111111111
        1000002000110000000000001
        101100000111000000020001
        1001000000000000000000001
111111111011000001110000000000001
100000000011000001110111100011111
11110111111111011100N00010001
11110111111111011101010010001
11000000110101011100000010201
10200000000000001100000010001
10000000000000001101010010001
1100000111010101111101111000111
11110111 1110101 101111010001
11111111 1111111 111111111111