R  1400 2000

SO ./pics/mossy.xpm 
WE ./pics/wood.xpm
EA ./pics/greystone.xpm
NO ./pics/redbricks.xpm
S ./pics/barrel.xpm
F 320,100,0
C  125,30,0
111111111111111111111
110000000222222220S1
11000000022222222001
10000000022222222001
10000000022222222001
10000000022222222001
12222222222222222001
12222222222222222001
12222222222222222001
12222222222222222001
12222222222222222001
12222222222222222001
12222222222222222001
12222222222222222001
12222222222222222001
12222222222222222001
12222222222222222001
12222222222222222001
12222222222222222001
12222222222222222001
12222222222222222001
12222222222222222001
12222222222222222001
12222222222222222001
12222222222222222001
12222222222222222001
11000000022222222001
10000000022222222001
10000000022222222001
10000000022222222001
12222222222222222001
12222222222222222001
12222222222222222001
12222222222222222001
12222222222222222001
12222222222222222001
12222222222222222001
12222222222222222001
12222222222222222001
12222222222222222001
12222222222222222001
12222222222222222001
12222222222222222001
12222222222222222001
12222222222222222001
12222222222222222001
12222222222222222001
12222222222222222001
12222222222222222001
12222222222222222001
11000000022222222001
10000000022222222001
10000000022222222001
10000000022222222001
12222222222222222001
12222222222222222001
12222222222222222001
12222222222222222001
12222222222222222001
12222222222222222001
12222222222222222001
12222222222222222001
12222222222222222001
12222222222222222001
12222222222222222001
12222222222222222001
12222222222222222001
12222222222222222001
12222222222222222001
12222222222222222001
12222222222222222001
12222222222222222001
12222222222222222001
12222222222222222001
11000000022222222001
10000000022222222001
10000000022222222001
10000000022222222001
12222222222222222001
12222222222222222001
12222222222222222001
12222222222222222001
12222222222222222001
12222222222222222001
12222222222222222001
12222222222222222001
12222222222222222001
12222222222222222001
12222222222222222001
12222222222222222001
12222222222222222001
12222222222222222001
12222222222222222001
12222222222222222001
12222222222222222001
12222222222222222001
12222222222222222001
12222222222222222001
11000000022222222001
10000000022222222001
10000000022222222001
10000000022222222001
12222222222222222001
12222222222222222001
12222222222222222001
12222222222222222001
12222222222222222001
12222222222222222001
12222222222222222001
12222222222222222001
12222222222222222001
12222222222222222001
12222222222222222001
12222222222222222001
12222222222222222001
12222222222222222001
12222222222222222001
12222222222222222001
12222222222222222001
12222222222222222001
12222222222222222001
12222222222222222001
11000000022222222001
10000000022222222001
10000000022222222001
10000000022222222001
12222222222222222001
12222222222222222001
12222222222222222001
12222222222222222001
12222222222222222001
12222222222222222001
12222222222222222001
12222222222222222001
12222222222222222001
12222222222222222001
12222222222222222001
12222222222222222001
12222222222222222001
12222222222222222001
12222222222222222001
12222222222222222001
12222222222222222001
12222222222222222001
12222222222222222001
12222222222222222001
12222222222222222001
12222222222222222001
12222222222222222001
12222222222222222001
12222222222222222001
12222222222222222001
12222222222222222001
12222222222222222001
12222222222222222001
12222222222222222001
12222222222222222001
12222222222222222001
12222222222222222001
12222222222222222001
12222222222222222001
12222222222222222001
12222222222222222001
11000000022222222001
10000000022222222001
10000000022222222001
10000000022222222001
12222222222222222001
12222222222222222001
12222222222222222001
12222222222222222001
12222222222222222001
12222222222222222001
12222222222222222001
12222222222222222001
12222222222222222001
12222222222222222001
12222222222222222001
12222222222222222001
12222222222222222001
12222222222222222001
12222222222222222001
12222222222222222001
12222222222222222001
12222222222222222001
12222222222222222001
12222222222222222001
11000000022222222001
10000000022222222001
10000000022222222001
10000000022222222001
12222222222222222001
12222222222222222001
12222222222222222001
12222222222222222001
12222222222222222001
12222222222222222001
12222222222222222001
12222222222222222001
12222222222222222001
12222222222222222001
12222222222222222001
12222222222222222001
12222222222222222001
12222222222222222001
12222222222222222001
12222222222222222001
12222222222222222001
12222222222222222001
12222222222222222001
12222222222222222001
11000000022222222001
10000000022222222001
10000000022222222001
10000000022222222001
12222222222222222001
12222222222222222001
12222222222222222001
12222222222222222001
12222222222222222001
12222222222222222001
12222222222222222001
12222222222222222001
12222222222222222001
12222222222222222001
12222222222222222001
12222222222222222001
12222222222222222001
12222222222222222001
12222222222222222001
12222222222222222001
12222222222222222001
12222222222222222001
12222222222222222001
12222222222222222001
11000000022222222001
10000000022222222001
10000000022222222001
10000000022222222001
12222222222222222001
12222222222222222001
12222222222222222001
12222222222222222001
12222222222222222001
12222222222222222001
12222222222222222001
12222222222222222001
12222222222222222001
12222222222222222001
12222222222222222001
12222222222222222001
12222222222222222001
12222222222222222001
12222222222222222001
12222222222222222001
12222222222222222001
12222222222222222001
12222222222222222001
12222222222222222001
11000000022222222001
10000000022222222001
10000000022222222001
10000000022222222001
12222222222222222001
12222222222222222001
12222222222222222001
12222222222222222001
12222222222222222001
12222222222222222001
12222222222222222001
12222222222222222001
12222222222222222001
12222222222222222001
12222222222222222001
12222222222222222001
12222222222222222001
12222222222222222001
12222222222222222001
12222222222222222001
12222222222222222001
12222222222222222001
12222222222222222001
12222222222222222001
12222222222222222001
12222222222222222001
12222222222222222001
12222222222222222001
12222222222222222001
12222222222222222001
12222222222222222001
12222222222222222001
12222222222222222001
12222222222222222001
12222222222222222001
12222222222222222001
12222222222222222001
12222222222222222001
12222222222222222001
12222222222222222001
12222222222222222001
11000000022222222001
10000000022222222001
10000000022222222001
10000000022222222001
12222222222222222001
12222222222222222001
12222222222222222001
12222222222222222001
12222222222222222001
12222222222222222001
12222222222222222001
12222222222222222001
12222222222222222001
12222222222222222001
12222222222222222001
12222222222222222001
12222222222222222001
12222222222222222001
12222222222222222001
12222222222222222001
12222222222222222001
12222222222222222001
12222222222222222001
12222222222222222001
11000000022222222001
10000000022222222001
10000000022222222001
10000000022222222001
12222222222222222001
12222222222222222001
12222222222222222001
12222222222222222001
12222222222222222001
12222222222222222001
12222222222222222001
12222222222222222001
12222222222222222001
12222222222222222001
12222222222222222001
12222222222222222001
12222222222222222001
12222222222222222001
12222222222222222001
12222222222222222001
12222222222222222001
12222222222222222001
12222222222222222001
12222222222222222001
11000000022222222001
10000000022222222001
10000000022222222001
10000000022222222001
12222222222222222001
12222222222222222001
12222222222222222001
12222222222222222001
12222222222222222001
12222222222222222001
12222222222222222001
12222222222222222001
12222222222222222001
12222222222222222001
12222222222222222001
12222222222222222001
12222222222222222001
12222222222222222001
12222222222222222001
12222222222222222001
12222222222222222001
12222222222222222001
12222222222222222001
12222222222222222001
11000000022222222001
10000000022222222001
10000000022222222001
10000000022222222001
12222222222222222001
12222222222222222001
12222222222222222001
12222222222222222001
12222222222222222001
12222222222222222001
12222222222222222001
12222222222222222001
12222222222222222001
12222222222222222001
12222222222222222001
12222222222222222001
12222222222222222001
12222222222222222001
12222222222222222001
12222222222222222001
12222222222222222001
12222222222222222001
12222222222222222001
12222222222222222001
11000000022222222001
10000000022222222001
10000000022222222001
10000000022222222001
12222222222222222001
12222222222222222001
12222222222222222001
12222222222222222001
12222222222222222001
12222222222222222001
12222222222222222001
12222222222222222001
12222222222222222001
12222222222222222001
12222222222222222001
12222222222222222001
12222222222222222001
12222222222222222001
12222222222222222001
12222222222222222001
12222222222222222001
12222222222222222001
12222222222222222001
12222222222222222001
12222222222222222001
12222222222222222001
12222222222222222001
12222222222222222001
12222222222222222001
12222222222222222001
12222222222222222001
12222222222222222001
12222222222222222001
12222222222222222001
12222222222222222001
12222222222222222001
12222222222222222001
12222222222222222001
12222222222222222001
12222222222222222001
12222222222222222001
11000000022222222001
10000000022222222001
10000000022222222001
10000000022222222001
12222222222222222001
12222222222222222001
12222222222222222001
12222222222222222001
12222222222222222001
12222222222222222001
12222222222222222001
12222222222222222001
12222222222222222001
12222222222222222001
12222222222222222001
12222222222222222001
12222222222222222001
12222222222222222001
12222222222222222001
12222222222222222001
12222222222222222001
12222222222222222001
12222222222222222001
12222222222222222001
11000000022222222001
10000000022222222001
10000000022222222001
10000000022222222001
12222222222222222001
12222222222222222001
12222222222222222001
12222222222222222001
12222222222222222001
12222222222222222001
12222222222222222001
12222222222222222001
12222222222222222001
12222222222222222001
12222222222222222001
12222222222222222001
12222222222222222001
12222222222222222001
12222222222222222001
12222222222222222001
12222222222222222001
12222222222222222001
12222222222222222001
12222222222222222001
11000000022222222001
10000000022222222001
10000000022222222001
10000000022222222001
12222222222222222001
12222222222222222001
12222222222222222001
12222222222222222001
12222222222222222001
12222222222222222001
12222222222222222001
12222222222222222001
12222222222222222001
12222222222222222001
12222222222222222001
12222222222222222001
12222222222222222001
12222222222222222001
12222222222222222001
12222222222222222001
12222222222222222001
12222222222222222001
12222222222222222001
12222222222222222001
11000000022222222001
10000000022222222001
10000000022222222001
10000000022222222001
12222222222222222001
12222222222222222001
12222222222222222001
12222222222222222001
12222222222222222001
12222222222222222001
12222222222222222001
12222222222222222001
12222222222222222001
12222222222222222001
12222222222222222001
12222222222222222001
12222222222222222001
12222222222222222001
12222222222222222001
12222222222222222001
12222222222222222001
12222222222222222001
12222222222222222001
12222222222222222001
11000000022222222001
10000000022222222001
10000000022222222001
10000000022222222001
12222222222222222001
12222222222222222001
12222222222222222001
12222222222222222001
12222222222222222001
12222222222222222001
12222222222222222001
12222222222222222001
12222222222222222001
12222222222222222001
12222222222222222001
12222222222222222001
12222222222222222001
12222222222222222001
12222222222222222001
12222222222222222001
12222222222222222001
12222222222222222001
12222222222222222001
12222222222222222001
12222222222222222001
12222222222222222001
12222222222222222001
12222222222222222001
12222222222222222001
12222222222222222001
12222222222222222001
12222222222222222001
12222222222222222001
12222222222222222001
12222222222222222001
12222222222222222001
12222222222222222001
12222222222222222001
12222222222222222001
12222222222222222001
12222222222222222001
11000000022222222001
10000000022222222001
10000000022222222001
10000000022222222001
12222222222222222001
12222222222222222001
12222222222222222001
12222222222222222001
12222222222222222001
12222222222222222001
12222222222222222001
12222222222222222001
12222222222222222001
12222222222222222001
12222222222222222001
12222222222222222001
12222222222222222001
12222222222222222001
12222222222222222001
12222222222222222001
12222222222222222001
12222222222222222001
12222222222222222001
12222222222222222001
11000000022222222001
10000000022222222001
10000000022222222001
10000000022222222001
12222222222222222001
12222222222222222001
12222222222222222001
12222222222222222001
12222222222222222001
12222222222222222001
12222222222222222001
12222222222222222001
12222222222222222001
12222222222222222001
12222222222222222001
12222222222222222001
12222222222222222001
12222222222222222001
12222222222222222001
12222222222222222001
12222222222222222001
12222222222222222001
12222222222222222001
12222222222222222001
11000000022222222001
10000000022222222001
10000000022222222001
10000000022222222001
12222222222222222001
12222222222222222001
12222222222222222001
12222222222222222001
12222222222222222001
12222222222222222001
12222222222222222001
12222222222222222001
12222222222222222001
12222222222222222001
12222222222222222001
12222222222222222001
12222222222222222001
12222222222222222001
12222222222222222001
12222222222222222001
12222222222222222001
12222222222222222001
12222222222222222001
12222222222222222001
11000000022222222001
10000000022222222001
10000000022222222001
10000000022222222001
12222222222222222001
12222222222222222001
12222222222222222001
12222222222222222001
12222222222222222001
12222222222222222001
12222222222222222001
12222222222222222001
12222222222222222001
12222222222222222001
12222222222222222001
12222222222222222001
12222222222222222001
12222222222222222001
12222222222222222001
12222222222222222001
12222222222222222001
12222222222222222001
12222222222222222001
12222222222222222001
11000000022222222001
10000000022222222001
10000000022222222001
10000000022222222001
12222222222222222001
12222222222222222001
12222222222222222001
12222222222222222001
12222222222222222001
12222222222222222001
12222222222222222001
12222222222222222001
12222222222222222001
12222222222222222001
12222222222222222001
12222222222222222001
12222222222222222001
12222222222222222001
12222222222222222001
12222222222222222001
12222222222222222001
12222222222222222001
12222222222222222001
12222222222222222001
12222222222222222001
12222222222222222001
12222222222222222001
12222222222222222001
12222222222222222001
12222222222222222001
12222222222222222001
12222222222222222001
12222222222222222001
12222222222222222001
12222222222222222001
12222222222222222001
12222222222222222001
12222222222222222001
12222222222222222001
12222222222222222001
12222222222222222001
11000000022222222001
10000000022222222001
10000000022222222001
10000000022222222001
12222222222222222001
12222222222222222001
12222222222222222001
12222222222222222001
12222222222222222001
12222222222222222001
12222222222222222001
12222222222222222001
12222222222222222001
12222222222222222001
12222222222222222001
12222222222222222001
12222222222222222001
12222222222222222001
12222222222222222001
12222222222222222001
12222222222222222001
12222222222222222001
12222222222222222001
12222222222222222001
11000000022222222001
10000000022222222001
10000000022222222001
10000000022222222001
12222222222222222001
12222222222222222001
12222222222222222001
12222222222222222001
12222222222222222001
12222222222222222001
12222222222222222001
12222222222222222001
12222222222222222001
12222222222222222001
12222222222222222001
12222222222222222001
12222222222222222001
12222222222222222001
12222222222222222001
12222222222222222001
12222222222222222001
12222222222222222001
12222222222222222001
12222222222222222001
11000000022222222001
10000000022222222001
10000000022222222001
10000000022222222001
12222222222222222001
12222222222222222001
12222222222222222001
12222222222222222001
12222222222222222001
12222222222222222001
12222222222222222001
12222222222222222001
12222222222222222001
12222222222222222001
12222222222222222001
12222222222222222001
12222222222222222001
12222222222222222001
12222222222222222001
12222222222222222001
12222222222222222001
12222222222222222001
12222222222222222001
12222222222222222001
11000000022222222001
10000000022222222001
10000000022222222001
10000000022222222001
12222222222222222001
12222222222222222001
12222222222222222001
12222222222222222001
12222222222222222001
12222222222222222001
12222222222222222001
12222222222222222001
12222222222222222001
12222222222222222001
12222222222222222001
12222222222222222001
12222222222222222001
12222222222222222001
12222222222222222001
12222222222222222001
12222222222222222001
12222222222222222001
12222222222222222001
12222222222222222001
11000000022222222001
10000000022222222001
10000000022222222001
10000000022222222001
12222222222222222001
12222222222222222001
12222222222222222001
12222222222222222001
12222222222222222001
12222222222222222001
12222222222222222001
12222222222222222001
12222222222222222001
12222222222222222001
12222222222222222001
12222222222222222001
12222222222222222001
12222222222222222001
12222222222222222001
12222222222222222001
12222222222222222001
12222222222222222001
12222222222222222001
12222222222222222001
12222222222222222001
12222222222222222001
12222222222222222001
12222222222222222001
12222222222222222001
12222222222222222001
12222222222222222001
12222222222222222001
12222222222222222001
12222222222222222001
12222222222222222001
12222222222222222001
12222222222222222001
12222222222222222001
12222222222222222001
12222222222222222001
12222222222222222001
11000000022222222001
10000000022222222001
10000000022222222001
10000000022222222001
12222222222222222001
12222222222222222001
12222222222222222001
12222222222222222001
12222222222222222001
12222222222222222001
12222222222222222001
12222222222222222001
12222222222222222001
12222222222222222001
12222222222222222001
12222222222222222001
12222222222222222001
12222222222222222001
12222222222222222001
12222222222222222001
12222222222222222001
12222222222222222001
12222222222222222001
12222222222222222001
11000000022222222001
10000000022222222001
10000000022222222001
10000000022222222001
12222222222222222001
12222222222222222001
12222222222222222001
12222222222222222001
12222222222222222001
12222222222222222001
12222222222222222001
12222222222222222001
12222222222222222001
12222222222222222001
12222222222222222001
12222222222222222001
12222222222222222001
12222222222222222001
12222222222222222001
12222222222222222001
12222222222222222001
12222222222222222001
12222222222222222001
12222222222222222001
11000000022222222001
10000000022222222001
10000000022222222001
10000000022222222001
12222222222222222001
12222222222222222001
12222222222222222001
12222222222222222001
12222222222222222001
12222222222222222001
12222222222222222001
12222222222222222001
12222222222222222001
12222222222222222001
12222222222222222001
12222222222222222001
12222222222222222001
12222222222222222001
12222222222222222001
12222222222222222001
12222222222222222001
12222222222222222001
12222222222222222001
12222222222222222001
11000000022222222001
10000000022222222001
10000000022222222001
10000000022222222001
12222222222222222001
12222222222222222001
12222222222222222001
12222222222222222001
12222222222222222001
12222222222222222001
12222222222222222001
12222222222222222001
12222222222222222001
12222222222222222001
12222222222222222001
12222222222222222001
12222222222222222001
12222222222222222001
12222222222222222001
12222222222222222001
12222222222222222001
12222222222222222001
12222222222222222001
12222222222222222001
11000000022222222001
10000000022222222001
10000000022222222001
10000000022222222001
12222222222222222001
12222222222222222001
12222222222222222001
12222222222222222001
12222222222222222001
12222222222222222001
12222222222222222001
12222222222222222001
12222222222222222001
12222222222222222001
12222222222222222001
12222222222222222001
12222222222222222001
12222222222222222001
12222222222222222001
12222222222222222001
12222222222222222001
12222222222222222001
12222222222222222001
12222222222222222001
12222222222222222001
12222222222222222001
12222222222222222001
12222222222222222001
12222222222222222001
12222222222222222001
12222222222222222001
12222222222222222001
12222222222222222001
12222222222222222001
12222222222222222001
12222222222222222001
12222222222222222001
12222222222222222001
12222222222222222001
12222222222222222001
12222222222222222001
11000000022222222001
10000000022222222001
10000000022222222001
10000000022222222001
12222222222222222001
12222222222222222001
12222222222222222001
12222222222222222001
12222222222222222001
12222222222222222001
12222222222222222001
12222222222222222001
12222222222222222001
12222222222222222001
12222222222222222001
12222222222222222001
12222222222222222001
12222222222222222001
12222222222222222001
12222222222222222001
12222222222222222001
12222222222222222001
12222222222222222001
12222222222222222001
11000000022222222001
10000000022222222001
10000000022222222001
10000000022222222001
12222222222222222001
12222222222222222001
12222222222222222001
12222222222222222001
12222222222222222001
12222222222222222001
12222222222222222001
12222222222222222001
12222222222222222001
12222222222222222001
12222222222222222001
12222222222222222001
12222222222222222001
12222222222222222001
12222222222222222001
12222222222222222001
12222222222222222001
12222222222222222001
12222222222222222001
12222222222222222001
11000000022222222001
10000000022222222001
10000000022222222001
10000000022222222001
12222222222222222001
12222222222222222001
12222222222222222001
12222222222222222001
12222222222222222001
12222222222222222001
12222222222222222001
12222222222222222001
12222222222222222001
12222222222222222001
12222222222222222001
12222222222222222001
12222222222222222001
12222222222222222001
12222222222222222001
12222222222222222001
12222222222222222001
12222222222222222001
12222222222222222001
12222222222222222001
11000000022222222001
10000000022222222001
10000000022222222001
10000000022222222001
12222222222222222001
12222222222222222001
12222222222222222001
12222222222222222001
12222222222222222001
12222222222222222001
12222222222222222001
12222222222222222001
12222222222222222001
12222222222222222001
12222222222222222001
12222222222222222001
12222222222222222001
12222222222222222001
12222222222222222001
12222222222222222001
12222222222222222001
12222222222222222001
12222222222222222001
12222222222222222001
11000000022222222001
10000000022222222001
10000000022222222001
10000000022222222001
12222222222222222001
12222222222222222001
12222222222222222001
12222222222222222001
12222222222222222001
12222222222222222001
12222222222222222001
12222222222222222001
12222222222222222001
12222222222222222001
12222222222222222001
12222222222222222001
12222222222222222001
12222222222222222001
12222222222222222001
12222222222222222001
12222222222222222001
12222222222222222001
12222222222222222001
12222222222222222001
10000000000000000001
10000000000000000001
10000000000000000001
10000000000000000001
10000000000000000001
10000000000000000001
10000000000000000001
10000000000000000001
10000000000000000001
10000000000000000001
10000000000000000001
10000000000000000001
10000000000000000001
10000000000000000001
10000000000000000001
10000000000000000001
10000000000000000001
10000000000000000001
10000000000000000001
10000000000000000001
10000000000000000001
10000000000000000001
10000000000000000001
10000000000000000001
10000000000000000001
10000000000000000001
10000000000000000001
10000000000000000001
10000000000000000001
10000000000000000001
10000000000000000001
10000000000000000001
10000000000000000001
10000000000000000001
10000000000000000001
10000000000000000001
10000000000000000001
10000000000000000001
10000000000000000001
10000000000000000001
10000000000000000001
10000000000000000001
10000000000000000001
10000000000000000001
10000000000000000001
10000000000000000001
10000000000000000001
10000000000000000001
10000000000000000001
10000000000000000001
10000000000000000001
10000000000000000001
10000000000000000001
10000000000000000001
10000000000000000001
10000000000000000001
10000000000000000001
10000000000000000001
10000000000000000001
10000000000000000001
10000000000000000001
10000000000000000001
10000000000000000001
10000000000000000001
10000000000000000001
10000000000000000001
10000000000000000001
10000000000000000001
10000000000000000001
10000000000000000001
10000000000000000001
10000000000000000001
10000000000000000001
10000000000000000001
10000000000000000001
10000000000000000001
10000000000000000001
10000000000000000001
10000000000000000001
10000000000000000001
10000000000000000001
10000000000000000001
10000000000000000001
10000000000000000001
10000000000000000001
10000000000000000001
10000000000000000001
10000000000000000001
10000000000000000001
10000000000000000001
10000000000000000001
10000000000000000001
10000000000000000001
10000000000000000001
10000000000000000001
10000000000000000001
10000000000000000001
10000000000000000001
10000000000000000001
12222222222222222221
11111111111111111111
